15
51
1
MMMMMMMMMMMMMMMMMMMMMMMMMMMMMMMMMMMMMMMMMMMMMMMM
MMMMMMMMMMMMMMMMMMMMMMMMMMMMMMMMMMMMMMMMMMMMMMMM
MMMMMMMMMMMMMMMMMMMMMMMMMMMMMMMMMMMMMMMMMMMMMMMM
MMMM||||||||||||||||||||||||||||||||||||||||MMMM
MMMM|MMMMMM_MMDMO_MMMMMOMOMMMMMMM_MMMMOMMMM|MMMM
MMMM|MOHOMMMMMM_MMMMMMMMMODMMOMMMM_MMMMM_MM|MMMM
MMMM|MMMMMMMMMM_MM_MMMMMOMOMMOMMMMMMMMOMMMM|MMMM
MMMM|OM__MMMMMMMMMOMMMMMMOMMOMMMMOMMMOMMMMM|MMMM
MMMM|OMOOMMMMMMMMMOOMMOMMMMMMMMOMMMMMMOMO_M|MMMM
MMMM|MMMOMMOMMMMMMMMOMMMMMOM_OMMMMMMMMOMOOM|MMMM
MMMM|||||||||||||||||||||||||||||||MMMOMMOM|MMMM
MMMM|M_MMMOMMDM_MMOMOMMMMMMMMMMDMO_MMMMMMOM|MMMM
MMMM|MMDMMMMMOMMMMM_MMMMMMMMO__OMMDMMMMOMMM|MMMM
MMMM|MMMOMMOMOMMMMMMMMMMMMMMOOMOMMOMMMMMMMM|MMMM
MMMM|M_OMMMMOMMMMMMMMOO_MMMMMMMOMMOMDMMMM_M|MMMM